00100000010010111
01101000000001011
00000100110001001
00000100010001001
00000101000000001
00000101010001001
00000101010001001
00000000000000000